{
    "maps": [
      {
        "name": 1,
        "design": [
          "#####--------------#########",
          "#   ###------------#~   ~~~#",
          "#     ##############~~~  ~~#",
          "#=             ?   ###~~ ###",
          "#===                      ~#",
          "#=======                ~~~#",
          "############################",
          "----------------------------",
          "----------------------------",
          "---TEST-MAP--------WIP------"
        ]
      },
      {
        "name": 2,
        "design": [
          "#####",
          "# # #",
          "#####"
        ]
      }
    ]
}